####################
#........##........#
#.##.###.##.###.##.#
#........PQ........#
#.##.##.####.##.##.#
#........##........#
####################
